Date,Block (Extra Large + Large),Overall,Extra Large,Large,Medium,Small
2023-01-03,-154400000,-22500000,-78700000,-75700000,56400000,75500000
2023-01-04,32830000,152550000,-79190000,112020000,160070000,-40350000
2023-01-05,-213710000,-323080000,1660000,-215370000,-86310000,-23070000
2023-01-06,36950000,353900000,-159260000,196210000,217850000,99100000
2023-01-09,-109820000,-32720000,-173810000,63990000,-42400000,119490000
2023-01-10,49010000,335880000,-67230000,116240000,119990000,166870000
2023-01-11,-4350000,-99840000,-27910000,23560000,-89180000,-6310000
2023-01-12,-121240000,-9340000,-126030000,4790000,21960000,89940000
2023-01-13,46010000,181040000,134410000,-88400000,67190000,67850000
2023-01-17,-701680000,-1120000000,-420750000,-280930000,-234690000,-186170000
2023-01-18,-719480000,-2430000000,-197990000,-521490000,-481890000,-1230000000
2023-01-19,-493250000,-932720000,-250420000,-242830000,-183760000,-255720000
2023-01-20,-218360000,312980000,-135150000,-83210000,234460000,296880000
2023-01-23,178890000,803950000,-56520000,235410000,202400000,422660000
2023-01-24,-261700000,-199560000,-194650000,-67050000,-104580000,166720000
2023-01-25,-214420000,-313000000,52150000,-266570000,26170000,-124750000
2023-01-26,30950000,203020000,-65660000,96610000,86360000,85700000
2023-01-27,-119700000,198140000,50800000,-170500000,127300000,190530000
2023-01-30,-385790000,-1020000000,-131810000,-253980000,-201400000,-428070000
2023-01-31,308460000,1570000000,-417280000,725740000,448510000,808340000
2023-02-01,336310000,363460000,100690000,235620000,65490000,-38340000
2023-02-02,95860000,277870000,59930000,35930000,-14890000,196920000
2023-02-03,-31760000,-837430000,169260000,-201020000,-63540000,-742130000
2023-02-06,-266030000,-602840000,-51690000,-214340000,-279820000,-56980000
2023-02-07,65940000,954940000,50900000,15040000,282920000,606070000
2023-02-08,70430000,-450850000,36310000,34120000,-165480000,-355800000
2023-02-09,91640000,-553630000,13510000,78130000,-70120000,-575140000
2023-02-10,-319420000,-441240000,-239680000,-79740000,-31070000,-90740000
2023-02-13,-349940000,-254460000,-294490000,-55450000,84270000,11210000
2023-02-14,-444100000,-736650000,-187580000,-256520000,37650000,-330200000
2023-02-15,362760000,468560000,326830000,35930000,157230000,-51440000
2023-02-16,-364930000,-1010000000,-140560000,-224370000,-171990000,-477810000
2023-02-17,-33480000,297250000,4850000,-38330000,185670000,145060000
2023-02-21,-585780000,-1560000000,-39110000,-546670000,-383870000,-586790000
2023-02-22,-153770330,-342510000,-310330,-153460000,2940000,-191680000
2023-02-23,-104650000,-737710000,-129540000,24890000,-44930000,-588130000
2023-02-24,-591920000,-1920000000,-41870000,-550050000,-92430000,-1230000000
2023-02-27,198030000,366170000,30280000,167750000,129120000,39030000
2023-02-28,-116530000,-893550000,143770000,-260300000,-363800000,-413220000
2023-03-01,-139590000,-991630000,-17380000,-122210000,-107360000,-744680000
2023-03-02,70430000,15650000,43340000,27090000,188120000,-242900000
2023-03-03,-31340000,998660000,-230900000,199560000,349680000,680310000
2023-03-06,202120000,-179910000,140240000,61880000,-73930000,-308090000
2023-03-07,-575570000,-1760000000,-59860000,-515710000,-252290000,-933520000
2023-03-08,83730000,289680000,-73250000,156980000,275590000,-69640000
2023-03-09,-744610000,-1540000000,-303950000,-440660000,-405090000,-386800000
2023-03-10,-132400000,-27540000,8320000,-140720000,6020000,98840000
2023-03-13,197990000,85520000,252610000,-54620000,13280000,-125750000
2023-03-14,-19840000,-537800000,-203310000,183470000,99900000,-617860000
2023-03-15,-297550000,-410100000,-108130000,-189420000,85100000,-197660000
2023-03-16,635790000,673140000,211140000,424650000,242370000,-205020000
2023-03-17,15890000,-810020000,130530000,-114640000,-378580000,-447330000
2023-03-20,325140000,-351440000,55760000,269380000,-8130000,-668440000
2023-03-21,191720000,223440000,70180000,121540000,42090000,-10370000
2023-03-22,-394990000,-1030000000,-32110000,-362880000,-282980000,-352310000
2023-03-23,-252530000,-592460000,-224960000,-27570000,9950000,-349870000
2023-03-24,-139320000,-342700000,19590000,-158910000,36240000,-239620000
2023-03-27,24820000,75010000,140580000,-115760000,-64730000,114920000
2023-03-28,44270000,169240000,8000000,36270000,29510000,95450000
2023-03-29,269310000,793930000,29460000,239850000,306480000,218140000
2023-03-30,114610000,122930000,24140000,90470000,46490000,-38160000
2023-03-31,-300010000,-92420000,-85440000,-214570000,92840000,114760000
2023-04-03,-70660000,65620000,28970000,-99630000,12580000,123710000
2023-04-04,-221470000,-287850000,-51720000,-169750000,-124170000,57800000
2023-04-05,-535550000,-432990000,-448620000,-86930000,-46450000,149010000
2023-04-06,116210000,591070000,-83920000,200130000,81320000,393530000
2023-04-10,-113750000,-134840000,63790000,-177540000,-97480000,76380000
2023-04-11,-90400000,-215440000,-29440000,-60960000,32660000,-157700000
2023-04-12,-231550000,-847010000,-33320000,-198230000,-216500000,-398970000
2023-04-13,53630000,772690000,9070000,44560000,114160000,604910000
2023-04-14,-203950000,-314940000,-96910000,-107040000,-64620000,-46370000
2023-04-17,-194400000,23340000,-17470000,-176930000,110290000,107450000
2023-04-18,-413260000,-185710000,-217540000,-195720000,55020000,172540000
2023-04-19,53740000,290410000,72630000,-18890000,151960000,84710000
2023-04-20,-80360000,-541040000,65260000,-145620000,-194360000,-266320000
2023-04-21,277260000,655230000,74460000,202800000,165960000,212000000
2023-04-24,-45450000,-59400000,68220000,-113670000,9240000,-23180000
2023-04-25,-397590000,-780640000,-201250000,-196340000,-483960000,100910000
2023-04-26,-329920000,-544450000,78440000,-408360000,-147640000,-66890000
2023-04-27,192157490,749580000,117490,192040000,286090000,271320000
2023-04-28,547740000,1260000000,247740000,300000000,171220000,538150000
2023-05-01,-846660000,-1060000000,-520640000,-326020000,-233550000,22060000
2023-05-02,-370110000,-877680000,-46520000,-323590000,57900000,-565470000
2023-05-03,-237220000,-637880000,-99330000,-137890000,-201950000,-198720000
2023-05-04,-180220000,6490000,-184990000,4770000,189090000,-2380000
2023-05-05,-7120000,740390000,-56930000,49810000,290550000,456960000
2023-05-08,-142470000,174660000,-70050000,-72420000,260100000,57020000
2023-05-09,-297200000,-730440000,-87770000,-209430000,-209260000,-223980000
2023-05-10,-398380000,-653890000,23990000,-422370000,-176190000,-79330000
2023-05-11,-140450000,-216540000,-28960000,-111490000,-83880000,7790000
2023-05-12,-273370000,-801980000,-154750000,-118620000,66930000,-595530000
2023-05-15,-22040000,-24960000,-76610000,54570000,90850000,-93770000
2023-05-16,-108660000,-606800000,4500000,-113160000,-25190000,-472950000
2023-05-17,450940000,952100000,183440000,267500000,232690000,268470000
2023-05-18,898430000,2160000000,200230000,698200000,492330000,772640000
2023-05-19,21780000,-454610000,72510000,-50730000,-140140000,-336250000
2023-05-22,127620000,528070000,-39100000,166720000,52990000,347460000
2023-05-23,198140000,83130000,151940000,46200000,135950000,-250950000
2023-05-24,-98260000,-933220000,80930000,-179190000,-249870000,-585080000
2023-05-25,-452660000,-767290000,-125380000,-327280000,-50570000,-264050000
2023-05-26,177160000,637990000,69860000,107300000,279820000,181010000
2023-05-30,260040000,563040000,-99770000,359810000,107400000,195610000
2023-05-31,-513820000,-1810000000,-94740000,-419080000,-407580000,-886580000
2023-06-01,-130080000,980180000,-99950000,-30130000,465050000,645210000
2023-06-02,143110000,946160000,-60040000,203150000,499820000,303230000
2023-06-05,543540000,1180000000,319800000,223740000,210450000,421730000
2023-06-06,347820000,719280000,68120000,279700000,230000000,141460000
2023-06-07,515320000,740020000,-3150000,518470000,-5310000,230000000
2023-06-08,-126470000,148210000,-171880000,45410000,98150000,176530000
2023-06-09,-97410000,75050000,2310000,-99720000,50230000,122220000
2023-06-12,385080000,889470000,70080000,315000000,332090000,172310000
2023-06-13,-19820000,-180610000,-96770000,76950000,13400000,-174180000
2023-06-14,-345540000,-967540000,-179120000,-166420000,-40410000,-581590000
2023-06-15,654820000,1610000000,155970000,498850000,323130000,627670000
2023-06-16,9810000,1200000000,-126900000,136710000,294760000,894070000
2023-06-20,161620000,278580000,212630000,-51010000,-177950000,294910000
2023-06-21,419280000,906830000,186270000,233010000,-90830000,578380000
2023-06-22,314890000,977280000,78920000,235970000,188800000,473580000
2023-06-23,-446310000,-1320000000,100610000,-546920000,-411510000,-458100000
2023-06-26,289260000,-95720000,186150000,103110000,-267980000,-117000000
2023-06-27,98500000,1130000000,50330000,48170000,318560000,713710000
2023-06-28,178700000,83050000,-14840000,193540000,-147120000,51470000
2023-06-29,325510000,289960000,48900000,276610000,98700000,-134250000
2023-06-30,-35690000,349130000,-79070000,43380000,-276070000,660890000
2023-07-03,-29280000,109060000,66930000,-96210000,105170000,33170000
2023-07-05,203480000,-370430000,236010000,-32530000,-183570000,-390350000
2023-07-06,-120070000,-399720000,-54630000,-65440000,-63120000,-216530000
2023-07-07,-311490000,-702170000,134180000,-445670000,-315400000,-75270000
2023-07-10,297070000,388480000,132480000,164590000,9970000,81440000
2023-07-11,505660000,1170000000,204020000,301640000,399430000,263330000
2023-07-12,361880000,973890000,27400000,334480000,-201900000,813920000
2023-07-13,159290000,1110000000,34340000,124950000,426200000,522720000
2023-07-14,-139780000,-160960000,117000000,-256780000,-503890,-20680000
2023-07-17,-318050000,-168340000,-127530000,-190520000,-50460000,200170000
2023-07-18,703480000,1760000000,94020000,609460000,624440000,431180000
2023-07-19,307710000,620070000,-2510000,310220000,410570000,-98210000
2023-07-20,-90290000,-592950000,27760000,-118050000,-646130000,143460000
2023-07-21,-223450000,-812220000,124850000,-348300000,-336890000,-251880000
2023-07-24,4150000,233720000,69290000,-65140000,100680000,128890000
2023-07-25,-298550000,-212550000,-213760000,-84790000,70540000,15460000
2023-07-26,198850000,46830000,74320000,124530000,-97800000,-54220000
2023-07-27,64390000,-1630000000,162820000,-98430000,-623220000,-1070000000
2023-07-28,-442560000,397570000,-256530000,-186030000,559820000,280320000
2023-07-31,280230000,-282340000,140250000,139980000,-245600000,-316980000
2023-08-01,21940000,398390000,-131420000,153360000,159370000,217090000
2023-08-02,-449060000,-1210000000,-92770000,-356290000,-440050000,-323640000
2023-08-03,-348220000,-102830000,-191560000,-156660000,-245780,245630000
2023-08-04,-58780000,-39250000,-9950000,-48830000,11620000,7910000
2023-08-07,-33170000,466820000,-132170000,99000000,169900000,330080000
2023-08-08,-64680000,-446010000,41000000,-105680000,-214130000,-167200000
2023-08-09,-604900000,-1320000000,-228040000,-376860000,-421390000,-290250000
2023-08-10,-53750000,-252070000,-144950000,91200000,-73160000,-125160000
2023-08-11,227980000,336110000,98540000,129440000,-121560000,229690000
2023-08-14,158000000,165950000,122000000,36000000,94280000,-86320000
2023-08-15,-522400000,-900190000,-146060000,-376340000,-245210000,-132570000
2023-08-16,-371990000,-300890000,-57170000,-314820000,-127740000,198830000
2023-08-17,-667500000,-1260000000,-289910000,-377590000,-255420000,-340860000
2023-08-18,412870000,505280000,-5260000,418130000,-11440000,103850000
2023-08-21,283830000,600170000,-5670000,289500000,210720000,105610000
2023-08-22,-378490000,-935900000,-190030000,-188460000,-74920000,-482480000
2023-08-23,440080000,697490000,5800000,434280000,322290000,-64880000
2023-08-24,-433270000,-946320000,-128030000,-305240000,-90670000,-422380000
2023-08-25,-257050000,-728660000,-22020000,-235030000,-186520000,-285090000
2023-08-28,31420000,-150240000,-104340000,135760000,60680000,-242340000
2023-08-29,652340000,1020000000,110780000,541560000,300630000,66530000
2023-08-30,507570000,296560000,241810000,265760000,-40720000,-170290000
2023-08-31,486870000,568680000,-54950000,541820000,118140000,-36340000
2023-09-01,-211830000,-464050000,-60450000,-151380000,-144570000,-107650000
2023-09-05,-126760000,-73470000,-76740000,-50020000,7250000,46040000
2023-09-06,-111120000,-418360000,-131040000,19920000,-157440000,-149810000
2023-09-07,586810000,1160000000,274140000,312670000,270960000,304920000
2023-09-08,73670000,524760000,146650000,-72980000,89600000,361480000
2023-09-11,44190000,643820000,2200000,41990000,247430000,352200000
2023-09-12,-58050000,36630000,10630000,-68680000,96090000,-1400000
2023-09-13,171620000,356280000,53940000,117680000,65130000,119540000
2023-09-14,848560000,1090000000,185230000,663330000,345750000,-104500000
2023-09-15,5430000,-30330000,-80030000,85460000,-9340000,-26420000
2023-09-18,-79520000,-256750000,-39170000,-40350000,-146230000,-31000000
2023-09-19,-88730000,-95640000,-98800000,10070000,149840000,-156740000
2023-09-20,-254870000,-719840000,4110000,-258980000,-264260000,-200710000
2023-09-21,-717480000,-2350000000,-39530000,-677950000,-754810000,-878860000
2023-09-22,-567980000,-781190000,-203990000,-363990000,141580000,-354790000
2023-09-25,320480000,716210000,126380000,194100000,290590000,105150000
2023-09-26,-306440000,-424200000,-132500000,-173940000,-159540000,41780000
2023-09-27,-215010000,526710000,-313550000,98540000,233850000,507870000
2023-09-28,542310000,867750000,-86760000,629070000,361290000,-35850000
2023-09-29,999460000,1800000000,-70540000,1070000000,530220000,269040000
2023-10-02,70240000,146640000,95350000,-25110000,137760000,-61360000
2023-10-03,-15050000,529490000,4710000,-19760000,101650000,442880000
2023-10-04,-508000000,-253030000,-427000000,-81000000,266090000,-11120000
2023-10-05,-183080000,-446320000,-189010000,5930000,-2030000,-261210000
2023-10-06,223700000,110050000,208830000,14870000,-171890000,58230000
2023-10-09,-112770000,143370000,-146950000,34180000,239080000,17050000
2023-10-10,510350000,606560000,100040000,410310000,175260000,-79050000
2023-10-11,341510000,470170000,1150000,340360000,130100000,-1440000
2023-10-12,-54270000,-616700000,-3840000,-50430000,-178570000,-383860000
2023-10-13,-481450000,-960560000,-142110000,-339340000,-100560000,-378550000
2023-10-16,-303900000,-376740000,-196360000,-107540000,-105920000,33080000
2023-10-17,286200000,441960000,74390000,211810000,195200000,-39440000
2023-10-18,-552830000,-876500000,-75650000,-477180000,-182900000,-140780000
2023-10-19,-578530000,-1580000000,-248490000,-330040000,-490530000,-511960000
2023-10-20,-844680000,-714140000,-267250000,-577430000,-365630000,496170000
2023-10-23,-406350000,-241790000,-113440000,-292910000,-12870000,177430000
2023-10-24,174140000,154360000,-118840000,292980000,229290000,-249070000
2023-10-25,-173750000,-323290000,171410000,-345160000,-183590000,34040000
2023-10-26,-266320000,10590000,-212010000,-54310000,-101930000,378840000