Date,Block (Extra Large + Large),Overall,Extra Large,Large,Medium,Small
2023-01-03,-7160000,-8680000,-13410000,6250000,-5660000,4140000
2023-01-04,9720000,10460000,-29680000,39400000,-5160000,5890000
2023-01-05,2840000,-67960000,-14600000,17440000,-24060000,-46730000
2023-01-06,-73910000,-512880000,-7270000,-66640000,-240830000,-198140000
2023-01-09,-41090000,-114990000,-16260000,-24830000,-43450000,-30450000
2023-01-10,-8730000,-104490000,-11720000,2990000,-58450000,-37320000
2023-01-11,-89830000,-231220000,-44630000,-45200000,-96190000,-45200000
2023-01-12,-36260000,-98510000,3330000,-39590000,-76370000,14120000
2023-01-13,-99340000,-241930000,-38150000,-61190000,-112300000,-30290000
2023-01-17,-2790000,-14820000,17090000,-19880000,-50200000,38160000
2023-01-18,39700000,196260000,4060000,35640000,75470000,81100000
2023-01-19,-54690000,-61580000,-32400000,-22290000,-30190000,23300000
2023-01-20,-145410000,-462650000,-47110000,-98300000,-172590000,-144660000
2023-01-23,-121480000,-350940000,-23960000,-97520000,-180030000,-49440000
2023-01-24,-63080000,-149890000,-9270000,-53810000,-75410000,-11400000
2023-01-25,-119820000,-277950000,-73420000,-46400000,-87120000,-71010000
2023-01-26,-103270000,-297090000,16410000,-119680000,-132330000,-61490000
2023-01-27,-108280000,-339050000,-13650000,-94630000,-144440000,-86330000
2023-01-30,-11040000,-8550000,-18820000,7780000,-22440000,24930000
2023-01-31,-56000000,-194140000,23530000,-79530000,-86900000,-51230000
2023-02-01,-155590000,-441200000,-12980000,-142610000,-163190000,-122430000
2023-02-02,-144510000,-285570000,-22610000,-121900000,-92150000,-48910000
2023-02-03,-36780000,-126150000,52080000,-88860000,-108960000,19590000
2023-02-06,-1600000,-73270000,11820000,-13420000,-38820000,-32850000
2023-02-07,-53360000,-172150000,-25870000,-27490000,-39430000,-79360000
2023-02-08,30390000,31330000,7490000,22900000,-872800,1820000
2023-02-09,91560000,175220000,23460000,68100000,4490000,79180000
2023-02-10,-97140000,-276000000,-39040000,-58100000,-101230000,-77630000
2023-02-13,-80650000,-244910000,-28420000,-52230000,-81560000,-82700000
2023-02-14,-114150000,-293920000,-42130000,-72020000,-93130000,-86640000
2023-02-15,-98850000,-280200000,-36020000,-62830000,-101110000,-80240000
2023-02-16,-117830000,-162880000,-94540000,-23290000,-38680000,-6370000
2023-02-17,-52520000,-167830000,-16120000,-36400000,-75020000,-40290000
2023-02-21,49580000,87920000,-26660000,76240000,9390000,28960000
2023-02-22,-43080000,-70110000,-24720000,-18360000,-10800000,-16240000
2023-02-23,-72670000,-134410000,-37400000,-35270000,-44600000,-17130000
2023-02-24,-5188150,-6380000,-4220000,-968150,-23060000,21860000
2023-02-27,-28590000,-35880000,-14780000,-13810000,3820000,-11120000
2023-02-28,-37790000,-55630000,-24230000,-13560000,-7480000,-10360000
2023-03-01,61060000,87620000,35170000,25890000,7170000,19400000
2023-03-02,-126840000,-341230000,-45880000,-80960000,-113180000,-101200000
2023-03-03,-170380000,-492250000,-69750000,-100630000,-145300000,-176570000
2023-03-06,-31190000,-62280000,-26980000,-4210000,-6650000,-24440000
2023-03-07,113290000,255510000,39690000,73600000,87130000,55090000
2023-03-08,-50670000,-144430000,-10220000,-40450000,-49420000,-44340000
2023-03-09,106120000,204500000,49050000,57070000,35970000,62410000
2023-03-10,-27670580,-201390000,-27040000,-630580,-85010000,-88710000
2023-03-13,-103960000,-305140000,-51030000,-52930000,-69940000,-131240000
2023-03-14,-95120000,-246430000,-47250000,-47870000,-43230000,-108070000
2023-03-15,-78940000,-203830000,-23070000,-55870000,-50500000,-74380000
2023-03-16,-131550000,-283160000,-42590000,-88960000,-54290000,-97310000
2023-03-17,-137340000,-227080000,-66650000,-70690000,-47280000,-42450000
2023-03-20,-74560000,-138450000,-23300000,-51260000,-24410000,-39480000
2023-03-21,-45820000,-166950000,11530000,-57350000,-51560000,-69570000
2023-03-22,-73170000,-188160000,-13920000,-59250000,-45300000,-69680000
2023-03-23,-30400000,-126440000,-10630000,-19770000,-43240000,-52800000
2023-03-24,-115030000,-215580000,-56430000,-58600000,-30900000,-69640000
2023-03-27,15060000,64300000,-6320000,21380000,29380000,19860000
2023-03-28,20280000,-23120000,16350000,3930000,-25130000,-18270000
2023-03-29,-115750000,-183300000,-50570000,-65180000,-24500000,-43050000
2023-03-30,-73090000,-167050000,-22720000,-50370000,-37150000,-56810000
2023-03-31,-108020000,-353560000,-37740000,-70280000,-91660000,-153880000
2023-04-03,-47320000,-91810000,-44760000,-2560000,-17740000,-26740000
2023-04-04,3770000,-27010000,6340000,-2570000,-13700000,-17090000
2023-04-05,-94500000,-135330000,-59180000,-35320000,-40340000,-505090
2023-04-06,-99750000,-205200000,-62140000,-37610000,-54950000,-50500000
2023-04-10,-35380000,-109810000,-8640000,-26740000,-30640000,-43790000
2023-04-11,-59730000,-47710000,-34540000,-25190000,-6260000,18290000
2023-04-12,-9640000,-16910000,-27240000,17600000,-8050000,774170
2023-04-13,-46660000,-259090000,12350000,-59010000,-74560000,-137880000
2023-04-14,40790000,26000000,-3820000,44610000,-5710000,-9080000
2023-04-17,-18710000,-77220000,7520000,-26230000,-16560000,-41950000
2023-04-18,-14330000,-19790000,-11640000,-2690000,-2820000,-2640000
2023-04-19,-57670000,-152920000,-17550000,-40120000,-38770000,-56480000
2023-04-20,62480000,51010000,21010000,41470000,-5320000,-6160000
2023-04-21,-48050000,-142360000,-17610000,-30440000,-47680000,-46630000
2023-04-24,-74910000,-94010000,-50270000,-24640000,-14170000,-4930000
2023-04-25,60200000,117750000,-10590000,70790000,32640000,24900000
2023-04-26,-36770000,-59770000,-14830000,-21940000,-5460000,-17530000
2023-04-27,-83890000,-257270000,-15210000,-68680000,-54710000,-118660000
2023-04-28,-99970000,-272420000,-33180000,-66790000,-60750000,-111710000
2023-05-01,-26320000,-59690000,-15300000,-11020000,-4410000,-28960000
2023-05-02,59380000,164650000,2800000,56580000,67170000,38090000
2023-05-03,-18200000,-5570000,-29210000,11010000,11370000,1280000
2023-05-04,76560000,107060000,28190000,48370000,31240000,-741460
2023-05-05,-63200000,-207890000,-22320000,-40880000,-46500000,-98200000
2023-05-08,-57830000,-98980000,-29540000,-28290000,-9140000,-32010000
2023-05-09,31520000,33160000,11570000,19950000,7350000,-5710000
2023-05-10,-61550000,-128470000,-25900000,-35650000,-23290000,-43620000
2023-05-11,-23160000,-81000000,-16140000,-7020000,-19520000,-38310000
2023-05-12,14440000,-26840000,17440000,-3000000,-25330000,-15960000
2023-05-15,-26210000,-62920000,-17060000,-9150000,34080,-36740000
2023-05-16,-33700000,-48980000,-5050000,-28650000,2580000,-17850000
2023-05-17,-70630000,-209270000,-13490000,-57140000,-49410000,-89240000
2023-05-18,-104150000,-213630000,-39120000,-65030000,-37640000,-71840000
2023-05-19,14370000,-62440000,19470000,-5100000,-36200000,-40610000
2023-05-22,-17590000,-52450000,-13000000,-4590000,-10710000,-24150000
2023-05-23,23430000,34450000,-1510000,24940000,12350000,-133000000
2023-05-24,-43990000,-36530000,-36460000,-7530000,16210000,-8740000
2023-05-25,-28084400,-45710000,-14400,-28070000,7130000,-24760000
2023-05-26,-153790000,-288320000,-80640000,-73150000,-39680000,-94860000
2023-05-30,4640000,70150000,-17030000,21670000,34640000,30870000
2023-05-31,-57315370,-113570000,-57050000,-265370,-27020000,-29230000
2023-06-01,-74020000,-155950000,-32460000,-41560000,-39330000,-42590000
2023-06-02,-96280000,-128000000,-40600000,-55680000,-5920000,-25800000
2023-06-05,3860000,-81430000,2270000,1590000,-40720000,-44570000
2023-06-06,-3320000,-76000000,9560000,-12880000,-40550000,-32130000
2023-06-07,22590000,67570000,3900000,18690000,12610000,32370000
2023-06-08,-20582470,-82490000,-642470,-19940000,-31000000,-31010000
2023-06-09,-53760000,-138140000,-26680000,-27080000,-37600000,-46780000
2023-06-12,-137180000,-249020000,-61570000,-75610000,-46030000,-65810000
2023-06-13,-28726560,-87320000,-28190000,-536560,-39870000,-18720000
2023-06-14,-9200000,-54110000,-26370000,17170000,-10950000,-33960000
2023-06-15,-108600000,-213380000,-51000000,-57600000,-56260000,-48510000
2023-06-16,-45040000,-65510000,-15530000,-29510000,-17800000,-2660000
2023-06-20,21810000,-14720000,5480000,16330000,-14990000,-21550000
2023-06-21,-47430000,-73900000,-30720000,-16710000,4680000,-31140000
2023-06-22,-49450000,-123630000,-19980000,-29470000,-37300000,-36870000
2023-06-23,-31990000,-78710000,-22260000,-9730000,-21500000,-25230000
2023-06-26,-38110000,-66710000,-46650000,8540000,6240000,-34840000
2023-06-27,-61310000,-165600000,-33670000,-27640000,-35260000,-69030000
2023-06-28,-87730000,-171940000,-70630000,-17100000,-29290000,-54910000
2023-06-29,-13740000,36970000,-8310000,-5430000,6720000,43980000
2023-06-30,-73790000,-145230000,-45510000,-28280000,-29100000,-42330000
2023-07-03,-24540000,-35490000,-3280000,-21260000,-6590000,-4350000
2023-07-05,-26530000,-68960000,-24680000,-1850000,-15220000,-27210000
2023-07-06,-11730000,-28600000,10130000,-21860000,-5260000,-11610000
2023-07-07,-13300000,-40920000,-8070000,-5230000,-5610000,-22000000
2023-07-10,-20900000,-44680000,-17090000,-3810000,-8580000,-15190000
2023-07-11,-24370000,-52020000,-6530000,-17840000,-15980000,-11660000
2023-07-12,-65930000,-130590000,-47460000,-18470000,-8930000,-55730000
2023-07-13,-47430000,-116270000,-21880000,-25550000,-23350000,-45480000
2023-07-14,-10104390,-46400000,-10990000,885610,-14800000,-21500000
2023-07-17,-21720000,-66770000,-7150000,-14570000,-14910000,-30130000
2023-07-18,-13000000,-48330000,-7070000,-5930000,-11760000,-23580000
2023-07-19,8780000,-29880000,-7180000,15960000,-29310000,-9340000
2023-07-20,57920000,93430000,21930000,35990000,11770000,23740000
2023-07-21,-38330000,-88160000,-26870000,-11460000,-22680000,-27140000
2023-07-24,-13850000,-42190000,-10730000,-3120000,-10710000,-17630000
2023-07-25,-21510000,-62160000,-8770000,-12740000,-11670000,-28990000
2023-07-26,-25050000,-54820000,-2680000,-22370000,-8790000,-20970000
2023-07-27,52730000,86510000,-13210000,65940000,12660000,21120000
2023-07-28,-56690000,-127510000,-34110000,-22580000,-18550000,-52260000
2023-07-31,14040000,14320000,5600000,8440000,2640000,-2370000
2023-08-01,29480000,25810000,1050000,28430000,109950,-3780000
2023-08-02,-75190000,-105420000,25680000,-100870000,-22750000,-7480000
2023-08-03,25090000,-1530000,20710000,4380000,-10590000,-16030000
2023-08-04,-7760000,-21000000,-10590000,2830000,-6060000,-7180000
2023-08-07,-32250000,-64900000,-15130000,-17120000,-22510000,-10140000
2023-08-08,-74180000,-114930000,-46430000,-27750000,-14900000,-25870000
2023-08-09,-120570000,-134390000,-93390000,-27180000,-11580000,-2250000
2023-08-10,-64970000,-67540000,-56420000,-8550000,-16170000,13590000
2023-08-11,-61320000,-105240000,-46350000,-14970000,-14360000,-29560000
2023-08-14,-165890000,-260810000,-53860000,-112030000,-46390000,-48540000
2023-08-15,23730000,63700000,-7460000,31190000,23150000,16830000
2023-08-16,-49300000,-66990000,-53200000,3900000,-12220000,-5470000
2023-08-17,-34020000,-7880000,-49550000,15530000,12030000,14120000
2023-08-18,-89050000,-165520000,-42950000,-46100000,-15530000,-60940000
2023-08-21,-103220000,-184600000,-49220000,-54000000,-27560000,-53820000
2023-08-22,21420000,51490000,24980000,-3560000,1620000,28460000
2023-08-23,-88290000,-193290000,-28190000,-60100000,-44180000,-60820000
2023-08-24,79960000,192250000,17520000,62440000,26270000,86020000
2023-08-25,-101330000,-204900000,-53150000,-48180000,-35830000,-67750000
2023-08-28,4640000,-21930000,-2300000,6940000,-8270000,-18300000
2023-08-29,-118020000,-273610000,-53880000,-64140000,-61950000,-93650000
2023-08-30,-88250000,-149480000,-38940000,-49310000,-19430000,-41790000
2023-08-31,-27270000,-40290000,-31230000,3960000,-3970000,-9050000
2023-09-01,5740000,-4510000,-10600000,16340000,-9460000,-786170
2023-09-05,-14330000,-51360000,-16180000,1850000,-15820000,-21210000
2023-09-06,-23397880,-32800000,-23240000,-157880,2620000,-12020000
2023-09-07,-33840000,-41960000,-25720000,-8120000,-1700000,-6420000
2023-09-08,-27350000,-86870000,-7630000,-19720000,-23570000,-35950000
2023-09-11,-62680000,-120460000,-26190000,-36490000,-24410000,-33370000
2023-09-12,4380000,8450000,12690000,-8310000,1040000,3030000
2023-09-13,2273420,-43750000,3140000,-866580,-23500000,-22530000
2023-09-14,3000000,-22430000,12400000,-9400000,-15510000,-9920000
2023-09-15,2730000,8550000,54970000,-52240000,-25780000,31600000
2023-09-18,-13100000,-68990000,-12010000,-1090000,-16640000,-39250000
2023-09-19,3400000,-14310000,11130000,-7730000,-7640000,-10050000
2023-09-20,59010000,73110000,23750000,35260000,10290000,3800000
2023-09-21,29230000,84720000,37190000,-7960000,5400000,50080000
2023-09-22,-25390000,-119080000,14880000,-40270000,-44060000,-49640000
2023-09-25,-16390000,-41270000,-3930000,-12460000,6320000,-31190000
2023-09-26,-13970000,-25250000,-7690000,-6280000,-6780000,-4500000
2023-09-27,-56360000,-120310000,-14060000,-42300000,-25310000,-38640000
2023-09-28,-73540000,-210620000,-28100000,-45440000,-75860000,-61220000
2023-09-29,-50910000,-86000000,-29480000,-21430000,-26120000,-8960000
2023-10-02,-27050000,-82360000,1200000,-28250000,-23030000,-32280000
2023-10-03,-2130000,19620000,9570000,-11700000,10130000,11610000
2023-10-04,-50080000,-154290000,-6590000,-43490000,-29970000,-74240000
2023-10-05,-1610000,5910000,-15740000,14130000,-3530000,11060000
2023-10-06,-194060000,-365270000,-92870000,-101190000,-68980000,-102240000
2023-10-09,-76000000,-142770000,-15630000,-60370000,-26280000,-40490000
2023-10-10,-35030000,-80710000,-17430000,-17600000,-18260000,-27410000
2023-10-11,-22830000,-84610000,8120000,-30950000,-28360000,-33420000
2023-10-12,-54250000,-65840000,-43880000,-10370000,-9440000,-2150000
2023-10-13,12960000,-7520000,18060000,-5100000,-16720000,-3760000
2023-10-16,-43490000,-82950000,-13910000,-29580000,-12510000,-26950000
2023-10-17,-31490000,-39580000,-22180000,-9310000,-10200000,2110000
2023-10-18,-18880000,-35610000,-11880000,-7000000,-11320000,-5410000
2023-10-19,105010000,210250000,30440000,74570000,33750000,71500000
2023-10-20,-22150000,-22110000,7650000,-29800000,-26520000,26560000
2023-10-23,-20220000,-93690000,-4880000,-15340000,-28580000,-44890000
2023-10-24,24620000,-8190000,30600000,-5980000,-8810000,-23990000
2023-10-25,-35100000,-18770000,-19910000,-15190000,5850000,10470000
2023-10-26,-57910000,-67200000,-24870000,-33040000,-8800000,-483450