Date,Block (Extra Large + Large),Overall,Extra Large,Large,Medium,Small
2023-01-03,-24020000,-96400000,6830000,-30850000,-31390000,-40980000
2023-01-04,-16970000,-45480000,-11090000,-5880000,-15700000,-12810000
2023-01-05,-61060000,-108650000,-39870000,-21190000,-21560000,-26030000
2023-01-06,31610000,46850000,33190000,-1580000,-5210000,20450000
2023-01-09,-20540000,-45430000,10990000,-31530000,-19890000,-5010000
2023-01-10,-14250000,-9320000,-27760000,13510000,-2700000,7630000
2023-01-11,16087000,41900000,-5193000,21280000,5150000,15520000
2023-01-12,8480000,-13850000,-14800000,23280000,20380000,-42710000
2023-01-13,-28110000,-60720000,-11800000,-16310000,-7040000,-25570000
2023-01-17,-37558230,-50890000,-598230,-36960000,-323400,-13010000
2023-01-18,-98100000,-217310000,-21180000,-76920000,-43210000,-76000000
2023-01-19,-30190000,-93280000,-27410000,-2780000,-20340000,-42740000
2023-01-20,82680000,120470000,37150000,45530000,19700000,18100000
2023-01-23,113170000,207260000,59180000,53990000,52390000,41700000
2023-01-24,26220000,-3970000,38320000,-12100000,-10090000,-20110000
2023-01-25,88730000,83480000,56050000,32680000,5550000,-10800000
2023-01-26,112910000,205180000,50850000,62060000,37700000,54570000
2023-01-27,41600000,65180000,16520000,25080000,11810000,11770000
2023-01-30,-22030000,-180700000,8000000,-30030000,-64440000,-94230000
2023-01-31,38050000,47620000,16580000,21470000,9190000,382770
2023-02-01,85730000,189640000,39880000,45850000,23210000,80690000
2023-02-02,115820000,232070000,56570000,59250000,34510000,81740000
2023-02-03,42720000,-70470000,38960000,3760000,-42520000,-70670000
2023-02-06,-15400000,-40760000,-13910000,-1490000,-20700000,-4650000
2023-02-07,38910000,47970000,11400000,27510000,5560000,3500000
2023-02-08,-124460000,-272530000,-34060000,-90400000,-58290000,-89780000
2023-02-09,-93550000,-332440000,-7110000,-86440000,-76170000,-162720000
2023-02-10,-23120000,-117860000,-8290000,-14830000,-33950000,-60790000
2023-02-13,10800000,78170000,-2610000,13410000,26400000,40960000
2023-02-14,-7430000,-22000000,6550000,-13980000,943890,-15510000
2023-02-15,43540000,122290000,-9100000,52640000,17310000,61440000
2023-02-16,-68830000,-150420000,-28060000,-40770000,-37570000,-44030000
2023-02-17,-17430000,-121560000,-2200000,-15230000,-33420000,-70710000
2023-02-21,-110440000,-235730000,-46850000,-63590000,-42430000,-82850000
2023-02-22,-10807850,-73380000,-217850,-10590000,-30180000,-32400000
2023-02-23,-65750000,-125120000,-40560000,-25190000,-22140000,-37230000
2023-02-24,-50080000,-189490000,-21560000,-28520000,-59150000,-80260000
2023-02-27,-5580000,-77950000,-20600000,15020000,-25710000,-46660000
2023-02-28,-38170000,-49500000,-20310000,-17860000,-7150000,-4180000
2023-03-01,23140000,-61020000,16760000,6380000,-29390000,-54760000
2023-03-02,59900000,152780000,15470000,44430000,31630000,61250000
2023-03-03,55030000,196330000,10840000,44190000,54280000,87030000
2023-03-06,9030000,-38970000,4780000,4250000,-33160000,-14850000
2023-03-07,-62130000,-327100000,8900000,-71030000,-116840000,-148150000
2023-03-08,-16910000,-34480000,-15410000,-1500000,5600000,-23160000
2023-03-09,-65990000,-244310000,-23090000,-42900000,-93790000,-84540000
2023-03-10,-125360000,-333680000,-84460000,-40900000,-53950000,-154370000
2023-03-13,3030000,27380000,-31710000,34740000,10980000,13370000
2023-03-14,-61790000,-54650000,-49760000,-12030000,-1030000,8170000
2023-03-15,-63460000,-114430000,-21620000,-41840000,-29980000,-20990000
2023-03-16,74680000,321070000,19860000,54820000,97450000,148940000
2023-03-17,-52570000,-177740000,1990000,-54560000,-86650000,-38510000
2023-03-20,-27800000,-19570000,-22380000,-5420000,6930000,1300000
2023-03-21,-8670000,59190000,-11150000,2480000,26630000,41230000
2023-03-22,-6760000,-27120000,-12320000,5560000,2510000,-22870000
2023-03-23,-63820000,-56830000,-51940000,-11880000,-18650000,25660000
2023-03-24,10690000,-67950000,12840000,-2150000,-18530000,-60120000
2023-03-27,-27520000,-142950000,6580000,-34100000,-57080000,-58340000
2023-03-28,-9050000,-75040000,-3830000,-5220000,-21920000,-44070000
2023-03-29,34910000,120310000,7410000,27500000,34920000,50480000
2023-03-30,74050000,120240000,34180000,39870000,26880000,19310000
2023-03-31,59500000,208310000,4910000,54590000,64120000,84690000
2023-04-03,13480000,106250000,9310000,4170000,51430000,41340000
2023-04-04,-6380000,-80520000,-3230000,-3150000,-18840000,-55300000
2023-04-05,-34240000,-110830000,-21250000,-12990000,-52590000,-24000000
2023-04-06,21960000,-21380000,18970000,2990000,-20720000,-22620000
2023-04-10,36890000,36030000,28960000,7930000,-4560000,3700000
2023-04-11,-4700000,-45330000,15660000,-20360000,-11760000,-28860000
2023-04-12,-35980000,-200510000,-28290000,-7690000,-30500000,-134030000
2023-04-13,80340000,211670000,36390000,43950000,51960000,79370000
2023-04-14,17450000,-17400000,2180000,15270000,-3820000,-31020000
2023-04-17,29340000,16560000,17660000,11680000,8650000,-21430000
2023-04-18,-44380000,-117900000,-19490000,-24890000,-14870000,-58650000
2023-04-19,-13550000,-3360000,4970000,-18520000,5720000,4470000
2023-04-20,7460000,-31110000,-6400000,13860000,-55470000,16890000
2023-04-21,-18858390,-64770000,-18180000,-678390,-18390000,-27530000
2023-04-24,-12180000,-107570000,2500000,-14680000,-59290000,-36100000
2023-04-25,-46730000,-249960000,-17130000,-29600000,-73350000,-129870000
2023-04-26,-25370000,-87100000,-18580000,-6790000,-28890000,-32850000
2023-04-27,-9020000,110930000,-30030000,21010000,22630000,97330000
2023-04-28,-2890000,7470000,-15140000,12250000,13900000,-3540000
2023-05-01,28860000,20670000,22980000,5880000,-1470000,-6710000
2023-05-02,-32120000,-162610000,3440000,-35560000,-66030000,-64450000
2023-05-03,-50780000,-173320000,-32950000,-17830000,-44470000,-78070000
2023-05-04,56680000,-16300000,9670000,47010000,-34310000,-38660000
2023-05-05,3950000,37000000,-15080000,19030000,1770000,31280000
2023-05-08,18690000,14890000,13920000,4770000,-5740000,1940000
2023-05-09,-4140000,-30970000,1330000,-5470000,-9610000,-17220000
2023-05-10,-4950000,8840000,-11490000,6540000,-6490000,20280000
2023-05-11,-17380000,16760000,-12480000,-4900000,20270000,13870000
2023-05-12,-39430000,-160860000,-16160000,-23270000,-49680000,-71750000
2023-05-15,-5000000,10050000,2830000,-7830000,-11340000,26390000
2023-05-16,-26680000,-36970000,-18600000,-8080000,-9310000,-980260
2023-05-17,19530000,97160000,12780000,6750000,27000000,50630000
2023-05-18,27570000,189160000,-2420000,29990000,35750000,125830000
2023-05-19,11250000,-56440000,32220000,-20970000,-28410000,-39290000
2023-05-22,10460000,7100000,3620000,6840000,-7980000,4620000
2023-05-23,-62760000,-236900000,-13820000,-48940000,-56890000,-117260000
2023-05-24,-54470000,-136540000,-30230000,-24240000,-30180000,-51890000
2023-05-25,-29920000,-8240000,-33150000,3230000,-9260000,30940000
2023-05-26,-5270000,97840000,-26550000,21280000,19980000,83140000
2023-05-30,-14870000,-101210000,-6910000,-7960000,-14020000,-72320000
2023-05-31,30400000,-50800000,21530000,8870000,-17010000,-64190000
2023-06-01,-300000,67840000,-31480000,31180000,3970000,64160000
2023-06-02,-44570000,-106440000,-42860000,-1710000,-21330000,-40550000
2023-06-05,-1360000,-81100000,16930000,-18290000,-34190000,-45540000
2023-06-06,-15330000,-6090000,-25700000,10370000,11740000,-2500000
2023-06-07,-95970000,-359280000,-30600000,-65370000,-71480000,-191830000
2023-06-08,7010000,59600000,-16560000,23570000,23400000,29200000
2023-06-09,-27540000,-208550000,-9340000,-18200000,-30350000,-150660000
2023-06-12,34820000,173930000,4000000,30820000,44770000,94340000
2023-06-13,-101710000,-183830000,-84280000,-17430000,-44000000,-38120000
2023-06-14,-9330000,-76310000,14370000,-23700000,-21830000,-45150000
2023-06-15,-20890000,238030000,-51150000,30260000,84240000,174670000
2023-06-16,-128180000,-354810000,-83390000,-44790000,-50900000,-175730000
2023-06-20,-10060000,-86170000,5970000,-16030000,-16130000,-59980000
2023-06-21,-42380000,-138150000,-20820000,-21560000,-30010000,-65760000
2023-06-22,-32560000,-15820000,-18100000,-14460000,658280,16080000
2023-06-23,-79210000,-173010000,-44640000,-34570000,-16940000,-76850000
2023-06-26,-32030000,-161230000,-10090000,-21940000,-28720000,-100490000
2023-06-27,-24170000,-9950000,-18710000,-5460000,7480000,6740000
2023-06-28,22640000,-27780000,32420000,-9780000,-18970000,-31440000
2023-06-29,-18400000,-72590000,-2210000,-16190000,-28310000,-25870000
2023-06-30,-76800000,-131620000,-29360000,-47440000,-12600000,-42220000
2023-07-03,10160000,-25910000,6670000,3490000,-15590000,-20480000
2023-07-05,-6894550,-40500000,-384550,-6510000,-6920000,-26680000
2023-07-06,8670000,-10470000,1030000,7640000,-8920000,-10220000
2023-07-07,3750000,-30810000,25030000,-21280000,-6580000,-27970000
2023-07-10,2706130,-12950000,606130,2100000,-22940000,7260000
2023-07-11,21060000,33530000,3070000,17990000,6780000,5700000
2023-07-12,-9670000,-75680000,-2510000,-7160000,-28740000,-37270000
2023-07-13,46290000,166960000,39030000,7260000,25290000,95380000
2023-07-14,-67140000,-183400000,-37000000,-30140000,-43220000,-73040000
2023-07-17,-10348480,70310000,-9940000,-408480,15830000,64840000
2023-07-18,-34890000,-62570000,-12650000,-22240000,-9320000,-18350000
2023-07-19,3880000,-14590000,11260000,-7380000,787940,-19220000
2023-07-20,-108990000,-282110000,-49990000,-59000000,-89100000,-84010000
2023-07-21,-9990000,-155810000,11230000,-21220000,-42990000,-102830000
2023-07-24,155680000,-32700000,173000000,-17320000,1500000,-18600000
2023-07-25,-3222700,64400000,137300,-3360000,4510000,63120000
2023-07-26,-21190000,-50880000,-6750000,-14440000,-12380000,-17320000
2023-07-27,-82460000,-305030000,-52040000,-30420000,-56160000,-166410000
2023-07-28,23670000,-20760000,22310000,1360000,-21260000,-23170000
2023-07-31,-30910000,-70930000,-15590000,-15320000,-38390000,-1620000
2023-08-01,-11180000,50130000,8210000,-19390000,-9450000,70760000
2023-08-02,-8770000,-146040000,-11360000,2590000,-36830000,-100450000
2023-08-03,-17200000,11200000,-19740000,2540000,8610000,19800000
2023-08-04,-89530000,-281780000,-30150000,-59380000,-85900000,-106340000
2023-08-07,12120000,-8910000,2270000,9850000,-17700000,-3320000
2023-08-08,-23160000,-99150000,-16530000,-6630000,258010,-76250000
2023-08-09,-57000000,-155430000,-40980000,-16020000,-28480000,-69950000
2023-08-10,-45500000,-148960000,-10790000,-34710000,-26760000,-76700000
2023-08-11,-35320000,-141500000,-21380000,-13940000,-18720000,-87460000
2023-08-14,-26890000,31590000,-25780000,-1110000,4120000,54360000
2023-08-15,-49990000,-143750000,-32000000,-17990000,-25660000,-68110000
2023-08-16,-91180000,-198410000,-52810000,-38370000,-15050000,-92190000
2023-08-17,-71860000,-262370000,-38040000,-33820000,-40610000,-149910000
2023-08-18,-44340000,-104380000,-32090000,-12250000,-4190000,-55850000
2023-08-21,-14490000,-41190000,1020000,-15510000,-97350,-26610000
2023-08-22,-58650000,-143070000,-62970000,4320000,-43860000,-40550000
2023-08-23,37850000,125910000,20940000,16910000,33950000,54110000
2023-08-24,-85560000,-349120000,-43090000,-42470000,-61160000,-202410000
2023-08-25,-18610000,-116420000,6950000,-25560000,-29970000,-67840000
2023-08-28,-2100000,-53320000,3220000,-5320000,-9980000,-41240000
2023-08-29,58300000,147950000,14060000,44240000,32710000,56960000
2023-08-30,27193990,-4240000,-586010,27780000,-4840000,-26590000
2023-08-31,-15801100,-61190000,-931100,-14870000,-2710000,-42680000
2023-09-01,-4328590,-126090000,-478590,-3850000,-22020000,-99740000
2023-09-05,-17710000,-18340000,-13880000,-3830000,-3960000,3330000
2023-09-06,-27770000,-120080000,-2970000,-24800000,-16410000,-75900000
2023-09-07,-30090000,-75180000,1000000,-31090000,-19320000,-25770000
2023-09-08,9010000,-62710000,21140000,-12130000,-9710000,-62020000
2023-09-11,-30610000,-68300000,-13130000,-17480000,-9460000,-28220000
2023-09-12,-43760000,-195490000,-38220000,-5540000,-42730000,-109000000
2023-09-13,8200000,-112580000,2010000,6190000,-20080000,-100700000
2023-09-14,14930000,-63380000,17870000,-2940000,-18700000,-59610000
2023-09-15,-96080000,-203340000,-57270000,-38810000,-25140000,-82120000
2023-09-18,-18110000,-84310000,-26880000,8770000,-2410000,-63790000
2023-09-19,-17340000,-48080000,-23750000,6410000,-12940000,-17800000
2023-09-20,-68910000,-239240000,-20420000,-48490000,-36140000,-134180000
2023-09-21,-83600000,-208450000,-34210000,-49390000,-43340000,-81520000
2023-09-22,4000000,-110900000,8510000,-4510000,-31770000,-83130000
2023-09-25,-19042630,-79510000,-22630,-19020000,-20610000,-39860000
2023-09-26,-48090000,-140110000,-7060000,-41030000,-19400000,-72620000
2023-09-27,-17830000,-136270000,2770000,-20600000,-45200000,-73240000
2023-09-28,-25540000,-54650000,-17810000,-7730000,-15500000,-13600000
2023-09-29,-49800000,-171320000,-17640000,-32160000,-38650000,-82870000
2023-10-02,-12410000,-43780000,2130000,-14540000,-1810000,-29560000
2023-10-03,-32010000,-195110000,-6770000,-25240000,-39560000,-123550000
2023-10-04,11360000,106970000,-22940000,34300000,32340000,63270000
2023-10-05,-64630000,-143470000,-35540000,-29090000,-20190000,-58640000
2023-10-06,53320000,-35590000,26670000,26650000,-21230000,-67690000
2023-10-09,29260000,31880000,27770000,1490000,-16500000,19120000
2023-10-10,-11690000,-72050000,-5740000,-5950000,-27960000,-32400000
2023-10-11,-12900000,-21040000,-11670000,-1230000,8550000,-16700000
2023-10-12,14270000,-82460000,7200000,7070000,-30780000,-65950000
2023-10-13,-65840000,-309770000,-22350000,-43490000,-78810000,-165110000
2023-10-16,7130000,18110000,5330000,1800000,-2400000,13380000
2023-10-17,-9708950,-92770000,-698950,-9010000,-11140000,-71920000
2023-10-18,-61480000,-232050000,-35340000,-26140000,-56190000,-114380000
2023-10-19,-58900000,-153010000,-35030000,-23870000,-22060000,-72050000
2023-10-20,-89050000,-209110000,-60150000,-28900000,-42460000,-77600000
2023-10-23,-87470000,-150970000,-42110000,-45360000,-30470000,-33040000
2023-10-24,-6450000,-22030000,11180000,-17630000,2580000,-18170000
2023-10-25,-61890000,-287480000,-22380000,-39510000,-67660000,-157920000
2023-10-26,-99080000,-257890000,-34080000,-65000000,-49900000,-108910000